*	a
ི	i
ུ	u
ེ	e
ོ	o
ཀ	k
ཁ	kh
ག	g
ང	ng
ཅ	c
ཆ	ch
ཇ	j
ཉ	ny
ཏ	t
ཐ	th
ད	d
ན	n
པ	p
ཕ	ph
བ	b
མ	m
ཙ	ts
ཚ	tsh
ཛ	dz
ཝ	w
ཞ	zh
ཟ	z
འ	v
ཡ	y
ར	r
ལ	l
ཤ	sh
ས	s
ཧ	h
ཨ	a
རྐ	rk
རྒ	rg
རྔ	rng
རྗ	rj
རྙ	rny
རྟ	rt
རྡ	rd
རྣ	rn
རྦ	rb
རྨ	rm
རྩ	rts
རྫ	rdz
ལྐ	lk
ལྒ	lg
ལྔ	lng
ལྕ	lc
ལྗ	lj
ལྟ	lt
ལྡ	ld
ལྤ	lp
ལྦ	lb
ལྷ	lh
སྐ	sk
སྒ	sg
སྔ	sng
སྙ	sny
སྟ	st
སྡ	sd
སྣ	sn
སྤ	sp
སྦ	sb
སྨ	sm
སྩ	sts
ཀྱ	ky
ཁྱ	khy
གྱ	gy
པྱ	py
ཕྱ	phy
བྱ	by
མྱ	my
ཀྲ	kr
ཁྲ	khr
གྲ	gr
ཏྲ	tr
ཐྲ	thr
དྲ	dr
པྲ	pr
ཕྲ	phr
བྲ	br
སྲ	sr
ཧྲ	hr
ཀླ	kl
གླ	gl
བླ	bl
ཟླ	zl
རླ	rl
སླ	sl
ཀྭ	kw
ཁྭ	khw
གྭ	gw
ཉྭ	nyw
དྭ	dw
ཚྭ	tshw
ཞྭ	zhw
ཟྭ	zw
རྭ	rw
ལྭ	lw
ཤྭ	shw
ཧྭ	hw
རྩྭ	rtsw
གྲྭ	grw
ཕྱྭ	bhyw
རྐྱ	rky
རྒྱ	rgy
རྨྱ	rmy
སྐྱ	sky
སྒྱ	sgy
སྤྱ	spy
སྦྱ	sby
སྨྱ	smy
སྐྲ	skr
སྒྲ	sgr
སྣྲ	snr
སྤྲ	spr
སྦྲ	sbr
སྨྲ	smr
ཧྥ	hph
བརྐ	brk
བརྒ	brg
བརྔ	brng
བརྗ	brj
བརྙ	brny
བརྟ	brt
བརྡ	brd
བརྣ	brn
བརྩ	brts
བརྫ	brdz
བལྐ	blk
བལྒ	blg
བལྟ	blt
བལྡ	bld